wwwwwwwwwwwwwwwwwwww
w_w________________w
wf_________________w
w__________________w
w______________p___w
w__________________w
w__________________w
w__________________w
w_______w__________w
w______w_w_________w
w_______b__________w
w__________________w
w__________________w
w__________________w
w__________________w
w__________________w
w__________________w
w__________________w
w__________________w
wwwwwwwwwwwwwwwwwwww
